
absent			缺席的，不在场的
bother			打扰
brothers 		兄弟
beans			豆（豆角，大豆）
bastard			混蛋， you bastard 你个混蛋
brave			勇敢，that's very brave of you.
champngne		香槟
carrot			胡萝卜
chilli			辣椒(干辣椒，红辣椒)
cabbage			白菜
cucumber		黄瓜
condoms			/kɑ:ndəmz/ 安全套
compass			/ˈkʌmpəs/ 指南针，罗盘
chivalrous		/ˈʃɪvəlrəs/ 侠义，侠，绅士风度的，彬彬有礼的(尤其对女人) eg: just tring to look chivalrous.
disappear		消失，完全客观的现象，没有前者语气强烈
discount		打折的，减价出售的
defeat			/dɪˈfit/ vt. 战胜，击败，宣告作废，n. 失败，战胜 两个极端的词义，具体看语境，
decline			（有礼貌的）拒绝
debate			/dɪˈbet/ 辩论，讨论，争论    debate on ...    we don't have time to debate this
				多指公开,正式场合进行的辩论或严肃的争论,双方各自陈述理由,"交锋""往返"的意味较强
discuss 		指为了解决问题或弄清对方的观点而进行的讨论,磋商
decent			得体的，合适的，相适宜的 decent person	好人，decent meal/job/place to live 不错的饭菜/工作/住所
entire			adj. 全部的，整个的，整体的，全部的
entirely		adv. 完全地，彻底地			全部，完全 n.
exit			/ˈeksɪt/	出口
exist			/ɪɡˈzɪst/	存在
evil			/ˈivəl]/ n. 邪恶，灾祸  adj. 邪恶的，罪恶的，有害的
frustrate 		/ˈfrʌstreɪt/ 阻挠，挫败，使感到灰心
fortunately		/ˈfɔ:rtʃənətli/ 幸运地
gloabl warming	全球变暖
grave			n. 坟墓， adj. 严重的，重要的 adv. 庄重的
kismet			/'kɪzmet/ 命运，天命
hairdresser		理发师
hiking			/ˈhaɪkɪŋ/ 徒步旅行
helicopter		直升机
homewrecker		拆散家庭的人，破坏别人家庭的人,小三
journal 		日记，日报，日志 
loophole		漏洞
laundry			洗衣店，洗衣房; 洗好的衣服; 待洗的衣服; 洗熨;
mystery			/ˈmɪstəri/ 谜	The source of the gunshots still remains a mystery。枪炮声来自何处仍是个谜。
nun				修女，尼姑
onion			洋葱
pinky swear		拉钩
present			/ˈprɛznt/ 出席的，在场的
peanut			/ˈpiˌnʌt/ 花生,微不足道的人，小人物; 很少的钱; adj. 微不足道的
piano recital  	钢琴独奏会
recital clause 	叙述性条款
refusal			拒绝
rejection		拒绝，语义较为强烈，断然拒绝的意味
rural			/ˈrʊrəl/ 乡下的， 农村的
rage			/reɪdʒ/ 愤怒
softball game 	垒球
sick			生病
shower			n. 淋浴，洗澡
shallot			小葱
surrender		/səˈrɛndɚ/ vi. 投降;自首;屈服 vt. 交出;放弃;使投降;听任 n.投降;放弃;屈服;（保险的）解约
stomachache		胃疼，don't eat to many, you will get a stomachache
vanish			消失，语气强,指完全、往往是神秘而突然的消失,不留任何蛛丝马迹
widow			/ˈwɪdoʊ/ 寡妇
widower			无妻或丧妻的男人







they say the water is so pure there, it will wash the past clean off you, and you can start again.
what did you see in him? 他哪里吸引到你？
take a shower			洗澡
soy stuff drinks		豆浆
me neither				我也是
OK, i am on my way.  	我马上过去
pull over 				靠边停车
today is my turn to say thanks,
i assumed he did 		我以为他做了
organize the cabinets	整理橱柜
kidney stone			肾结石
i will pick you up.		我来接你
 reliance		n.   信任、信赖、依靠，不仅指心理或感觉上的信任，而且也指在行动上客观表现出来的信赖乃至依靠。
 confidence		n.   信心、自信、信念、信任，指对自己或自己的能力非常自信，也指基于经验而对事物有把握；还指人与人之间能推心置腹的信任。一般这些信任都是有一定证据基础
 				adj. 骗得信任的; 欺诈的
 faith			n.   信任、信仰、信念，指有充分确凿的证据或充足的理由而相信。
 belief			n.   相信，词义较广，指对某事物在思想上认同或接受其真实性，至于确凿的证据可有可无，并不影响这种相信。
 believe		vt.  相信;信任,信赖

 英语中有很多名词用作动词的地方
 1. Father（父亲）：He fathered her child.（他是她孩子的父亲。）
 2. Lemon（柠檬）：Can you lemon my tea, please?（请给我的茶加点柠檬好吗？）
 3. Sandwich（三明治）：The man was sandwiched between the two cops.（那名男子被挟在两名警察中间。）
 4. Red-pencil（红铅笔）：My teacher red-penciled all my errors.（我老师把我错的地方全用红铅笔标了出来。）